HHHHHHHHHHH
H011100000H
H101010000H
H01C100000H
H101110000H
H010100000H
H010100000H
H010100000H
H0101000N0H
H010100000H
HHHHHHHHHHH