HHHHHHHHHHH
H01110000NH
H101010000H
H01CW00000H
H101WWW000H
H0WWW0W000H
H0W010000WH
H0W0W0000WH
H0W01000WWH
WWWWWWWW0SH
HHHHHHHHHHH