HHHHHHHHHHH
H01110000NH
H101010II+H
H01C000000H
H101000000H
H00000000SH
H0001000--H
H000000000H
H000000000H
H000000000H
HHHHHHHHHHH