HHHHHHHHHHH
H01110000NH
H101010000H
H01C000000H
H101000000H
H000000000H
H000100000H
H000000000H
HI-⅃L<Γbd0H
H⊥T0+00000H
HHHHHHHHHHH