NNNNNNNTN
NSNPPPTTT
SSSPPPTTT
SSSDPWWWN
NNDDDWWWN
NNDDDHWNN
NNNNHHHNN
NNNNHHHNN