NNNNNSSSNN
NNNNNSPSNN
NNNPPPSWNN
NNNPWPWPWN
NNNNPNWWWN
NNNNNNNNNN
NNNNNNNNNN
NNNNNNNNNN
NNNNNNNNNN
NNNNNNNNNN
