NSWMNSNNNN
NNSMSSSNNN
NNNWSSSNNN
NNNWWWNNNN
NNNNNNNNNN
NNNNNNNNNN
NNNNNNNNNN
NNNNNNNNNN
NNNNNNNNNN
NNNNNNNNNN
