NNNNNNNNNN
NSSSNWWWNN
NSSSNWWWNN
NNSNNNWNNN
NNNNNNNNNN
NNNNNNNNNN
NNNNNNNNNN
NNNNNNNNNN
NNNNNNNNNN
NNNNNNNNNN
