NNNWWWNNNN
NNNWSWNNNN
NNNMWMNNNN
NPSSMWWWNN
NPPSMWSWNN
NNPNNNWNNN
NNNNNNNNNN
NNNNNNNNNN
NNNNNNNNNN
NNNNNNNNNN
