NNWMNNNNNN
NNMWWWNNNN
NNNWSWNNNN
NNNNWMMNNN
NNNNNNSNNN
NNNNNNNNNN
NNNNNNNNNN
NNNNNNNNNN
NNNNNNNNNN
NNNNNNNNNN
