NWNNNNNNNN
NMMWNNNNNN
NNWSWNNNNN
NNWWWMNNNN
NNNNMSNNNN
NNNNNNNNNN
NNNNNNNNNN
NNNNNNNNNN
NNNNNNNNNN
NNNNNNNNNN
