NNNNNNNNNN
NSSSMWWWNN
NSMSMWMWNN
NNSNMNWNNN
NNNNNNNNNN
NNNNNNNNNN
NNNNNNNNNN
NNNNNNNNNN
NNNNNNNNNN
NNNNNNNNNN
