NNNNNSSSNN
NNNNNSWSNN
NNNWWWSWNN
NNNWWWWSWN
NNNNWNWWWN
NNNNNNNNNN
NNNNNNNNNN
NNNNNNNNNN
NNNNNNNNNN
NNNNNNNNNN
