PPNNNNNNNN
PNNNNNNNNN
PPNNNNNNNN
PNNPPNNNNN
PPNPPPNWWN
PNNPPNWWWN
PPDNNDDWWN
PPNNDDDNNN
PPNNNDDNNN
PPNNNNNNNN
