NNNPPPNNNN
NNNPPPNNNN
NNDDDPNNNN
NNNPPPNNNN
NNWWWNNNNN
NNNPPPNNNN